1,1,1,1,1,1,1,1,1,1
1,4,0,0,0,0,0,0,5,1
1,0,0,0,0,0,0,0,0,1
1,0,0,0,0,0,0,0,0,1
1,0,0,0,0,0,0,0,0,1
1,0,0,0,0,0,0,0,0,1
1,2,0,0,0,0,0,0,6,1
1,1,1,1,1,1,1,1,1,1
